merhaba=hello
ben=I
fare=mouse
kule=tower
büyük=big
güçsüz=weak
küçük=small
güçlü=strong
hızlı=fast
zengin=rich
yavaş=slow
fakir=poor
iyi=good
genç=young
kötü=bad
yaşlı=old
pahalı=expensive
güzel=beautiful
ucuz=cheap
çirkin=ugly
mutlu=happy
ağır=heavy
üzgün=sad
hafif=light
zor=difficult
sert=hard
kolay=easy
yumuşak=soft
uzun=long
zeki=intelligent
kısa=short
aptal=stupid
dolu=full
kirli=dirty
boş=empty
temiz=clean
